343001,164.49152,576,327,4435,0,0,0,0,0,0,0,0,0,0,0,0,0,0,0,0
343004,351.959757,1348,801,10971,0,0,0,0,0,0,0,0,0,0,0,0,0,0,0,0
343005,450.80384,1529,928,12844,0,0,0,0,0,0,0,0,0,0,0,0,0,0,0,0
343007,6920.798272,2485,654,6638,0,0,0,0,0,0,0,0,0,0,0,0,0,0,0,0
343009,1461.138048,5172,3108,42731,0,0,0,0,0,0,0,0,0,0,0,0,0,0,0,0
343018,2979.209057,10811,6466,88884,0,0,0,0,0,0,0,0,0,0,0,0,0,0,0,0
343025,5.812096,59,36,479,0,0,0,0,0,0,0,0,0,0,0,0,0,0,0,0
343034,45552.57677,159860,91151,1258495,0,0,0,0,0,0,0,0,0,0,0,0,0,0,0,0
343037,0.24736,1,1,11,0,0,0,0,0,0,0,0,0,0,0,0,0,0,0,0
343040,0.194872,3,2,28,0,0,0,0,0,0,0,0,0,0,0,0,0,0,0,0
343042,5250.581749,17968,10527,134446,0,0,0,0,0,0,0,0,0,0,0,0,0,0,0,0
343045,378.755276,1330,777,9953,0,0,0,0,0,0,0,0,0,0,0,0,0,0,0,0
343046,7495.584704,25451,14922,191890,0,0,0,0,0,0,0,0,0,0,0,0,0,0,0,0
343059,1116.528384,3868,2255,28809,0,0,0,0,0,0,0,0,0,0,0,0,0,0,0,0
343068,11127.46008,37782,22086,283399,0,0,0,0,0,0,0,0,0,0,0,0,0,0,0,0
343070,1425.763968,4842,2784,35115,109,0,0,0,0,0,109,28,53,28,8,20,29,24,7,21
343080,6093.432536,20777,12147,153075,501,0,0,0,0,0,501,174,195,132,82,92,99,96,48,84
343082,38239.56172,128390,73641,930180,3052,0,0,0,0,0,3052,1076,1040,936,555,521,512,528,436,500
343164,190.282944,636,385,6304,48,35,8,12,8,7,13,6,5,2,3,3,2,3,1,1
343167,2212.161792,7773,4503,74689,651,483,44,168,108,163,168,75,57,36,43,32,26,31,18,18
343169,924.77696,3268,1904,32171,307,250,28,91,61,70,57,23,21,13,14,9,7,14,8,5
343170,166.892767,491,279,5006,50,40,0,17,9,14,10,2,1,7,2,0,1,0,1,6
343171,6054.723264,21784,12556,221340,1884,1429,159,485,336,449,455,198,140,117,103,95,80,60,36,81
343259,342.363844,1035,593,10497,76,53,7,14,11,21,23,7,11,5,2,5,5,6,4,1
343260,239.091648,738,417,7269,81,73,14,30,14,15,8,2,1,5,0,2,0,1,0,5
343266,33026.46391,117638,67190,1179153,9717,7121,828,2534,1545,2214,2596,1077,884,635,504,573,462,422,305,330
343268,7655.579136,27539,15830,277806,2389,1793,248,597,396,552,596,214,207,175,89,125,112,95,74,101
343375,295.661824,1270,767,13629,0,0,0,0,0,0,0,0,0,0,0,0,0,0,0,0
343380,817.964416,3353,1860,32775,0,0,0,0,0,0,0,0,0,0,0,0,0,0,0,0
343384,268.948166,1100,628,10787,0,0,0,0,0,0,0,0,0,0,0,0,0,0,0,0
343385,404.544832,1658,936,16602,0,0,0,0,0,0,0,0,0,0,0,0,0,0,0,0
343386,793.928576,3145,1777,31385,0,0,0,0,0,0,0,0,0,0,0,0,0,0,0,0
343387,39938.72626,159534,89588,1539564,12525,9145,1061,3285,2018,2781,3380,1256,1172,952,625,631,596,576,495,457
343494,1396.945984,5902,3610,64065,968,907,67,145,277,418,61,14,21,26,10,4,14,7,11,15
343496,9706.936032,41656,25594,450581,5817,5433,361,859,1696,2517,384,146,137,101,82,64,69,68,42,59
343498,30423.53744,129573,79462,1396580,19127,17872,1310,2931,5593,8038,1255,456,454,345,248,208,242,212,169,176
343501,270.406016,1267,743,13065,175,159,5,33,46,75,16,2,6,8,0,2,1,5,0,8
343609,4944.211496,20927,11189,193632,0,0,0,0,0,0,0,0,0,0,0,0,0,0,0,0
343619,23793.25303,99721,53735,907460,4310,1998,319,1111,229,339,2312,859,770,683,382,477,346,424,328,355
343621,13114.53914,55272,29792,503070,2489,1194,179,681,147,187,1295,500,452,343,233,267,212,240,160,183
343623,2443.908352,10394,5616,95775,486,237,44,122,33,38,249,92,88,69,35,57,42,46,38,31
343625,23056.09882,97331,51696,906665,13192,12852,693,1502,4322,6335,340,139,116,85,90,49,71,45,42,43
343627,166.757882,702,377,6594,111,108,5,18,35,50,3,1,0,2,1,0,0,0,2,0
343629,64.214272,371,202,3513,56,55,6,7,18,24,1,0,1,0,0,0,1,0,0,0
343638,7868.48712,32962,17675,309462,4363,4235,247,450,1452,2086,128,47,49,32,23,24,25,24,13,19
343640,8757.946373,31472,16818,282142,744,180,32,146,1,1,564,210,190,164,87,123,97,93,90,74
343642,43066.13056,182272,97784,1640587,4531,1130,178,942,9,1,3401,1347,1060,994,667,680,504,556,465,529
343644,11642.7985,49159,26364,455203,4852,4798,179,317,1694,2608,54,21,22,11,13,8,16,6,3,8
343646,1533.208978,6469,3496,60882,0,0,0,0,0,0,0,0,0,0,0,0,0,0,0,0
343648,4126.083965,17366,9135,158650,1721,1700,54,116,621,909,21,5,3,13,4,1,1,2,7,6
343650,35.83968,202,114,1993,22,22,0,1,7,14,0,0,0,0,0,0,0,0,0,0
343652,89.372288,441,236,4234,38,38,2,2,11,23,0,0,0,0,0,0,0,0,0,0
343663,677.732094,2753,1468,24777,14,0,0,0,0,0,14,3,3,8,1,2,1,2,1,7
343668,5895.46112,25136,13356,222796,143,0,0,0,0,0,143,54,34,55,18,36,14,20,14,41
343673,466.249286,94,48,687,0,0,0,0,0,0,0,0,0,0,0,0,0,0,0,0
343677,19894.48352,84177,45209,753308,434,1,0,0,1,0,433,129,166,138,33,96,67,99,65,73
343680,28127.13619,118412,63405,1059157,626,1,0,0,1,0,625,247,201,177,94,153,90,111,70,107
343762,223.406398,53,23,348,0,0,0,0,0,0,0,0,0,0,0,0,0,0,0,0
343763,410.697856,98,33,504,0,0,0,0,0,0,0,0,0,0,0,0,0,0,0,0
343767,3711.376064,15688,8466,145925,0,0,0,0,0,0,0,0,0,0,0,0,0,0,0,0
343769,806.199168,3412,1827,31879,0,0,0,0,0,0,0,0,0,0,0,0,0,0,0,0
343772,1412.651535,5175,2725,47909,840,726,37,113,208,368,114,37,45,32,11,26,22,23,9,23
343774,39589.60251,167038,89351,1571217,26392,22579,1123,2776,7605,11075,3813,1383,1295,1135,665,718,618,677,556,579
343854,239.596992,52,26,399,2,0,0,0,0,0,2,2,0,0,0,2,0,0,0,0
343860,1104.798528,5084,3011,53475,937,801,49,152,243,357,136,53,51,32,21,32,24,27,19,13
343862,38645.52717,172814,103021,1815278,28832,24957,1333,4420,7617,11587,3875,1447,1362,1066,662,785,673,689,484,582
343864,4875.665408,21857,13118,230082,3723,3204,181,578,996,1449,519,191,159,169,94,97,91,68,85,84
343866,677.976448,165,85,1269,4,1,0,0,0,1,3,0,2,1,0,0,2,0,1,0
343874,262.62848,7,3,41,0,0,0,0,0,0,0,0,0,0,0,0,0,0,0,0
343875,130.360192,5,2,36,0,0,0,0,0,0,0,0,0,0,0,0,0,0,0,0
343876,138.655872,5,5,87,0,0,0,0,0,0,0,0,0,0,0,0,0,0,0,0
343877,188.676412,8,3,34,0,0,0,0,0,0,0,0,0,0,0,0,0,0,0,0
343878,187.103574,2,2,19,0,0,0,0,0,0,0,0,0,0,0,0,0,0,0,0
343881,611.446413,14,9,104,0,0,0,0,0,0,0,0,0,0,0,0,0,0,0,0
343921,483.952252,116,62,927,0,0,0,0,0,0,0,0,0,0,0,0,0,0,0,0
343923,177.941632,32,11,152,0,0,0,0,0,0,0,0,0,0,0,0,0,0,0,0
343925,416.710976,107,52,715,0,0,0,0,0,0,0,0,0,0,0,0,0,0,0,0
343927,263.497152,3,2,29,0,0,0,0,0,0,0,0,0,0,0,0,0,0,0,0
343928,817.00512,4,2,28,0,0,0,0,0,0,0,0,0,0,0,0,0,0,0,0
343932,704.942656,5,4,67,0,0,0,0,0,0,0,0,0,0,0,0,0,0,0,0
343934,2354.192249,10040,6031,105477,1687,1429,64,214,465,686,258,98,88,72,58,40,45,43,53,19
343936,8917.914752,40128,23651,417291,6708,5798,293,1029,1804,2672,910,314,303,293,162,152,168,135,95,198
343937,39170.92439,175828,104977,1854210,30173,26042,1392,4615,8107,11928,4131,1598,1454,1079,733,865,675,779,525,554
344001,53564.58989,183750,0,0,0,0,0,0,0,0,0,0,0,0,0,0,0,0,0,0
344049,1118.606208,5307,3165,55388,0,0,0,0,0,0,0,0,0,0,0,0,0,0,0,0
344058,2684.305408,17,11,181,0,0,0,0,0,0,0,0,0,0,0,0,0,0,0,0
344062,571.92923,2612,1567,27248,383,341,17,60,109,155,42,23,9,10,13,10,4,5,3,7
344063,75012.81862,338795,201112,3541051,57528,49585,2585,8704,15373,22923,7943,3015,2766,2162,1430,1585,1323,1443,1021,1141
344064,85737.74835,389335,230972,4069738,67378,58303,3094,10398,17931,26880,9075,3416,3180,2479,1555,1861,1592,1588,1156,1323
344065,3306.216832,14968,8884,157968,2556,2212,119,385,681,1027,344,129,130,85,57,72,51,79,38,47
344067,17177.3129,78206,46146,814397,13144,11351,605,2072,3492,5182,1793,660,589,544,337,323,257,332,242,302
344068,35212.22671,160394,95032,1674443,27488,23693,1498,4199,7217,10779,3795,1407,1281,1107,635,772,637,644,568,539
344121,3015.305664,13270,7658,132795,0,0,0,0,0,0,0,0,0,0,0,0,0,0,0,0
344124,75.25906,1,1,18,0,0,0,0,0,0,0,0,0,0,0,0,0,0,0,0
344128,2531.946752,568,250,3709,29,15,0,3,6,6,14,4,4,6,2,2,1,3,3,3
344134,55101.74854,229471,121270,2138657,40137,34901,2243,6282,10617,15759,5236,2106,1732,1398,985,1121,811,921,632,766
344184,1766.267008,7453,3947,69568,1372,1157,66,207,356,528,215,100,61,54,44,56,28,33,24,30
344185,3440.730192,14373,7586,133264,2564,2201,159,458,643,941,363,143,116,104,52,91,47,69,56,48
344186,39862.26854,167103,88342,1564045,29535,25450,1577,4595,7631,11647,4085,1496,1362,1227,739,757,690,672,575,652
344187,89.61184,305,172,3062,72,71,10,17,17,27,1,0,0,1,0,0,0,0,0,1
344188,3645.45122,15233,8005,142087,2702,2391,164,443,721,1063,311,97,118,96,55,42,58,60,34,62
344258,144.691356,46,12,121,0,0,0,0,0,0,0,0,0,0,0,0,0,0,0,0
344259,190.328704,613,304,5210,80,68,9,15,17,27,12,6,3,3,0,6,2,1,2,1
344260,1477.374237,6256,3248,56626,978,828,49,157,250,372,150,60,52,38,37,23,27,25,11,27
344265,15.841536,71,44,769,21,19,0,3,7,9,2,0,2,0,0,0,2,0,0,0
344266,47106.34062,196745,104656,1849430,35393,30480,1951,5495,9216,13818,4913,1931,1629,1353,915,1016,802,827,638,715
344267,1678.13568,7090,3993,70201,1131,987,76,169,287,455,144,54,46,44,33,21,25,21,16,28
344270,1.291392,20,11,237,0,0,0,0,0,0,0,0,0,0,0,0,0,0,0,0
344271,495.780985,1989,1178,20458,260,214,4,31,67,112,46,23,14,9,4,19,6,8,6,3
344272,1389.83584,6,1,18,0,0,0,0,0,0,0,0,0,0,0,0,0,0,0,0
344348,2206.574208,8180,4798,83530,0,0,0,0,0,0,0,0,0,0,0,0,0,0,0,0
344349,27.121856,181,95,1615,0,0,0,0,0,0,0,0,0,0,0,0,0,0,0,0
344350,313.838208,1269,710,12674,0,0,0,0,0,0,0,0,0,0,0,0,0,0,0,0
344351,4.76147,48,25,467,12,10,0,0,4,6,2,0,2,0,0,0,2,0,0,0
344358,420.621824,2,1,14,0,0,0,0,0,0,0,0,0,0,0,0,0,0,0,0
344362,5263.741952,11,6,95,4,0,0,0,0,0,4,2,1,1,0,2,0,1,0,1
344363,252.304448,1,1,7,0,0,0,0,0,0,0,0,0,0,0,0,0,0,0,0
344366,30024.27962,112272,65216,1160441,20300,17823,1178,3300,5417,7928,2477,909,820,748,388,521,372,448,332,416
344403,3182.34592,11629,6796,119854,0,0,0,0,0,0,0,0,0,0,0,0,0,0,0,0
344409,760.490816,2911,1663,29358,499,442,23,78,123,218,57,22,13,22,5,17,8,5,12,10
344416,1764.984896,6644,3856,69212,1329,1158,93,237,341,487,171,56,56,59,20,36,21,35,34,25
344419,24.545157,144,75,1414,34,25,4,4,11,6,9,2,7,0,2,0,0,7,0,0
344420,71476.05392,266717,155812,2775787,47584,41814,2805,7837,12561,18611,5770,2176,1964,1630,1023,1153,911,1053,756,874
344421,83244.43731,309465,180252,3209703,54934,48161,3071,9022,14486,21582,6773,2507,2302,1964,1064,1443,1023,1279,845,1119
344423,57999.74266,213826,124180,2212988,38656,33941,2180,6294,10186,15281,4715,1753,1619,1343,825,928,666,953,578,765
344424,1686.86432,6326,3698,65782,1098,934,56,166,292,420,164,51,77,36,10,41,26,51,16,20
344426,682.077056,2562,1470,26085,419,386,31,74,117,164,33,18,5,10,6,12,0,5,3,7
344432,80.112896,245,137,2490,57,49,8,12,14,15,8,4,0,4,0,4,0,0,1,3
344433,987.704,3602,2101,37545,654,566,43,111,164,248,88,31,43,14,8,23,25,18,8,6
344434,475.423488,1645,984,17406,348,301,15,58,94,134,47,10,25,12,8,2,23,2,8,4
344436,1144.184512,4036,2352,41266,0,0,0,0,0,0,0,0,0,0,0,0,0,0,0,0
344518,44059.34185,159448,86022,1535052,30042,26361,1722,4760,8017,11862,3681,1357,1286,1038,588,769,578,708,516,522
344519,1272.8656,4669,2805,50084,0,0,0,0,0,0,0,0,0,0,0,0,0,0,0,0
344520,2367.341504,8251,4674,83199,0,0,0,0,0,0,0,0,0,0,0,0,0,0,0,0
344529,4.119808,16,6,154,0,0,0,0,0,0,0,0,0,0,0,0,0,0,0,0
344533,26.066304,129,70,1295,0,0,0,0,0,0,0,0,0,0,0,0,0,0,0,0
344538,14766.38759,48923,28275,503786,0,0,0,0,0,0,0,0,0,0,0,0,0,0,0,0
344555,1073.315136,3621,2087,37583,794,720,46,133,218,323,74,22,29,23,9,13,13,16,6,17
344558,1211.578529,4142,2365,43257,923,829,77,163,254,335,94,31,38,25,21,10,17,21,15,10
344560,295.773059,1067,605,10949,206,180,12,32,51,85,26,17,5,4,5,12,1,4,1,3
344561,571.393472,1934,1120,20338,409,368,17,62,116,173,41,13,14,14,8,5,7,7,10,4
344562,321.592448,1,1,22,0,0,0,0,0,0,0,0,0,0,0,0,0,0,0,0
344565,414.523008,1355,763,14019,270,240,19,40,66,115,30,7,11,12,1,6,0,11,5,7
344566,48956.49933,156787,88149,1593317,32497,28746,1830,5296,8903,12717,3751,1497,1256,998,691,806,619,637,502,496
344567,1565.755712,5048,2817,49673,0,0,0,0,0,0,0,0,0,0,0,0,0,0,0,0
344568,3544.379904,11649,6556,116700,0,0,0,0,0,0,0,0,0,0,0,0,0,0,0,0
344606,610.133037,1980,1074,19216,0,0,0,0,0,0,0,0,0,0,0,0,0,0,0,0
344607,1331.036813,4389,2379,42239,0,0,0,0,0,0,0,0,0,0,0,0,0,0,0,0
344617,102.213312,352,213,3743,0,0,0,0,0,0,0,0,0,0,0,0,0,0,0,0
344618,890.041472,2915,1795,31092,0,0,0,0,0,0,0,0,0,0,0,0,0,0,0,0
344621,2976.470037,9767,6016,106536,0,0,0,0,0,0,0,0,0,0,0,0,0,0,0,0
344625,1468.105472,6,6,96,0,0,0,0,0,0,0,0,0,0,0,0,0,0,0,0
344632,53369.84922,193606,107969,1924923,37300,32658,2057,6011,9934,14656,4642,1763,1618,1261,931,832,869,749,630,631
344633,3801.380672,13815,7678,135687,0,0,0,0,0,0,0,0,0,0,0,0,0,0,0,0
344634,895.603712,3296,1833,31771,0,0,0,0,0,0,0,0,0,0,0,0,0,0,0,0
344654,332.75648,1,0,0,0,0,0,0,0,0,0,0,0,0,0,0,0,0,0,0
344657,2853.856499,10439,5820,102926,0,0,0,0,0,0,0,0,0,0,0,0,0,0,0,0
344665,1286.03968,4852,2638,46166,0,0,0,0,0,0,0,0,0,0,0,0,0,0,0,0
344666,520.951616,2026,1117,20261,455,404,26,71,132,175,51,12,25,14,3,9,8,17,12,2
344675,324.608832,1,1,18,0,0,0,0,0,0,0,0,0,0,0,0,0,0,0,0
344676,634.629568,2443,1319,23771,365,322,11,60,86,165,43,15,15,13,7,8,10,5,5,8
344677,1323.076778,4998,2709,48525,918,770,28,140,239,363,148,42,56,50,14,28,25,31,23,27
344678,759.633319,2863,1605,28293,459,419,26,74,116,203,40,14,17,9,7,7,7,10,8,1
344679,56822.40699,211436,114145,2032663,38791,33874,2024,6333,10234,15283,4917,1891,1648,1378,914,977,809,839,638,740
344680,425.813312,1724,898,16022,309,262,16,54,81,111,47,26,5,16,13,13,2,3,11,5
344681,15124.60109,56417,30540,544862,10467,9121,607,1661,2724,4129,1346,530,445,371,289,241,193,252,187,184
